Shoot to thrill - AC/DC
Thunderstruck - AC/DC
Highway to Hell - AC/DC
Master of Puppets - Metallica
Shape Of You - Ed Sheeran
Detroit Rock City - KISS
Danger Zone - Kenny Loggins
Radio gaga - Queen
Archangel - Elena Siegman
We All Fall Down - Clark S. Nova
I Want to Break Free - Queen
All the Stars are close - Kendrick Lamar
Closer - The Chainsmokers
Side To Side - Ariana Grande
Poker Face - Lady Gaga
Problem - Ariana Grande
Rude - MAGIC!
Counting Stars - One Republic
Something in the Way - Nirvana
Just Dance - Lady Gaga
Super Max - Pitstop Boys
Children of the Elder God - Old Gods of Asgard
Boys don't cry - The cure
Dream On - Aerosmith
Learn to fly - Foo Fighters
Murder in my mind - KORDHELL
Driving with the top down - Ramin Djawadi
House of Memories - Panic!At the Disco
Boys Wanna Be Her - Peaches
Join the Rior - Paddy and The Rats